1111111111
1500000001
1011000001
1011000101
1000000001
1000000001
1010000001
1001000101
1000000001
1000000001
1001000101
1000000001
1111111111
